



11111111111111
10C100000C0001
11000111110001
1P0011000E1001
11111111111111

