



11111111111111
100100000C0001
10000111110001
1P001100E00001
11111111111111

