



11111111111111
10C100C000C001
11000111110001
1P0011000E0001
11111111111111

